5 20 20
####################
#.A.......#...#....#
#...#..#@...#......#
#..##############..#
#.##............#..#
#..#..###B###...#..#
##.#..#c#.#.#...#..#
#..#..#.#...#...#..#
#.##..#.###.#...#..#
#..#..#.#C#.#...#.b#
##.#..#.C?#.#...#..#
#..#..#.###.#...#..#
#.##..#.....#...#..#
#..#..#######...#..#
##.#............#..#
#..#............#..#
##.#####A########..#
#..#.a#............#
#.....#.######...#.#
####################